10 10
ST########
####K##X##
CMFB###X##
#######X##
####XXXX##
#X########
#X########
#XXX######
##########
##########