10 10
S#########
BCMKTF#X##
#######X##
#######X##
####XXXX##
#X########
#X########
#XXX######
##########
##########